//1,2,3,4,5,6,7,8,9,10,11,12,13,14,15,16,17,18,19,20,21,22,23,24,25,26,27,28,29,30,31,32
99,100,100,100,100,100,100,100,100,100,100,100,100,100,0,0,0,0,0,100,100,100,100,100,100,0,0,0,0,0,0,99
0,100,100,100,100,100,100,100,100,100,100,100,100,100,0,0,0,0,0,100,100,100,100,100,100,0,100,100,100,100,100,100
0,100,100,100,100,100,100,100,100,100,100,100,100,100,9,0,0,0,9,100,100,100,100,100,100,0,100,100,100,100,100,100
0,100,100,100,0,0,0,0,0,100,100,100,100,100,400,0,200,0,400,100,100,100,100,100,100,0,100,100,100,100,100,100
0,100,100,100,0,100,100,100,0,100,100,100,100,100,0,0,0,0,0,100,100,100,100,100,100,0,100,100,100,100,100,100
0,100,100,100,0,100,100,100,0,100,100,100,100,100,0,0,0,0,0,100,100,100,100,100,100,0,100,100,100,100,100,100
0,100,100,100,0,100,100,100,0,100,100,100,100,100,0,0,0,0,0,100,100,100,100,100,100,0,100,100,100,100,100,100
0,100,100,100,0,100,100,100,0,100,100,100,100,100,100,100,0,100,100,100,0,0,0,0,0,0,100,100,100,100,100,100
0,100,100,100,0,100,100,100,0,100,100,0,0,0,0,100,0,100,0,100,0,100,100,100,0,100,100,100,100,100,100,100
0,100,100,100,0,100,100,100,0,100,100,0,0,0,0,100,0,100,0,100,0,100,100,100,0,100,100,100,100,100,100,100
0,0,0,0,0,0,0,0,0,0,0,0,0,0,0,0,0,0,0,100,0,100,100,100,0,100,100,100,100,100,100,100
100,100,100,100,100,100,100,100,100,100,100,0,0,0,0,0,0,0,0,100,0,100,100,100,0,0,0,0,0,100,100,100
100,100,100,100,100,100,100,100,100,100,100,0,0,0,0,0,0,0,0,0,0,100,100,100,0,100,100,100,0,100,100,100
100,100,100,100,100,100,0,0,0,0,100,0,0,0,0,0,0,0,0,100,100,100,100,100,0,100,100,100,0,100,100,100
100,100,100,100,100,100,0,0,0,0,100,0,0,0,0,0,0,0,0,0,0,100,100,100,0,100,100,100,0,100,100,100
100,100,100,100,100,100,0,0,0,0,100,0,100,0,100,100,0,0,100,100,0,0,0,0,0,100,100,100,0,100,100,100
0,0,0,0,100,100,0,0,0,0,100,0,100,0,100,0,0,0,0,100,0,100,0,100,100,100,100,100,0,100,100,100
0,100,100,0,100,100,0,0,0,0,100,0,100,0,100,0,0,0,0,100,0,100,0,100,100,100,100,100,0,100,100,100
0,100,100,0,100,100,0,0,0,0,0,0,100,0,0,0,0,0,0,0,0,100,0,100,100,100,0,0,0,100,100,100
0,100,100,0,100,100,0,100,100,100,100,0,100,0,0,0,0,30,0,0,0,100,0,100,100,100,100,100,100,100,100,100
0,100,100,0,100,100,0,100,100,100,100,0,100,0,100,0,0,0,0,100,0,100,0,0,0,100,100,100,100,100,100,100
0,100,100,0,100,100,0,100,100,100,100,0,100,0,100,0,0,0,0,100,0,100,100,100,0,100,100,100,100,100,100,100
0,100,100,0,0,0,0,100,100,100,100,0,100,0,100,100,0,0,100,100,0,100,100,100,0,100,100,100,100,100,100,100
99,100,100,100,100,100,100,100,100,100,100,0,0,0,0,0,0,0,0,0,0,0,0,0,0,0,0,0,0,0,0,99
